########
# O #  #
### ## #
#   ## #
## #   #
#    # #
########
